EEWWEWEEWWEWEWEEWEWEWEEWEWEWEWEEWEEW
EEWEWEEWEWEWEWEEWEWEWEEWEEWEEWEWEEWE
WEWEWEEWEWEWEEWEEWEEWEWEEWEWEWEWEEWE
WEWEEWEEWEEWEWEWEEWEWEWEWEWEWEWEEWEW
EEWEWEWEWEWEWEWEWEWEWEWEWEEWEWEEWEWE
WEWEWEWEWEWEWEWEWEWEEWEWEEWEWEWEWEWE
WEWEWEWEWEWEWEEWEWEEWEWEWEWEWEWEWEWE
WEWEWEWEEWEWEEWEWEWEWEWEWEWEWEWEWEWE
WEEWEWEEWEWEWEWEWEWEWEWEWEWEWEWEEWEW
EEWEWEWEWEWEWEWEWEWEWEWEWEEWEWEEWEWE
WEWEWEWEWEWEWEWEWEWEEWEWEEWEWEWEWEWE
WEWEWEWEWEWEWEEWEWEEWEWEWEWEWEWEWEWE
WEWEWEWEEWEWEEWEWEWEWEWEWEWEWEWEWEWE
WEEWEWEEWEWEWEWEWEWEWEWEWEWEWEWEEWEW
EEWEWEWEWEWEWEWEWEWEWEWEWEEWEWEEWEWE
WEWEWEWEWEWEWEWEWEWEEWEWEEWEWEWEWEWE
WEWEWEWEWEWEWEEWEWEEWEWEWEWEWEWEWEWE
WEWEWEWEEWEWEEWEWEWEWEWEWEWEWEWEWEWE
WEEWEWEEWEWEWEWEWEWEWEWEWEWEWEWEEWEW
EEWEWEWEWEWEWEWEWEWEWEWEWEEWEWEEWEWE
WEWEWEWEWEWEWEWEWEWEEWEWEEWEWEWEWEWE
WEWEWEWEWEWEWEEWEWEEWEWEWEWEWEWEWEWE
WEWEWEWEEWEWEEWEWEWEWEWEWEWEWEWEWEWE
WEEWEWEEWEWEWEWEWEWEWEWEWEWEWEWEEWEW
EEWEWEWEWEWEWEWEWEWEWEWEWEEWEWEEWEWE
WEWEWEWEWEWEWEWEWEWEEWEWEEWEWEWEWEWE
WEWEWEWEWEWEWEEWEWEEWEWEWEWEWEWEWEWE
WEWEWEWEWEEWEWEEWEWEWEWEWEWEWEWEWEWE
WEWEWEEWEWEEWEWEWEWEWEWEWEWEWEWEWEWE
EWEWEEWEWEWEWEWEWEWEWEWEWEWEWEEWEWEE
WEWEWEWEWEWEWEWEWEWEWEWEEWEWEEWEWEWE
WEWEWEWEWEWEWEWEWEEWEWEEWEWEWEWEWEWE
WEWEWEWEWEWEEWEWEEWEWEWEWEWEWEWEWEWE
WEWEWEEWEWEEWEWEWEWEWEWEWEWEWEWEWEWE
EWEWEEWEWEWEWEWEWEWEWEWEWEWEWEEWEWEE
WEWEWEWEWEWEWEWEWEWEWEWEEWEWEEWEWEWE
