EEWWEWEEWWEWEWEEWEWEWEEWEWEWEWEEWEEWW
EEWEWEEWEWEWEWEEWEWEWEEWEEWEEWEWEEWEE
WEWEWEEWEWEWEEWEEWEEWEWEEWEWEWEWEEWEW
WEWEEWEEWEEWEWEWEEWEWEWEWEWEWEWEEWEWE
EEWEWEWEWEWEWEWEWEWEWEWEWEEWEWEEWEWEW
WEWEWEWEWEWEWEWEWEWEEWEWEEWEWEWEWEWEE
WEWEWEWEWEWEWEEWEWEEWEWEWEWEWEWEWEWEW
WEWEWEWEEWEWEEWEWEWEWEWEWEWEWEWEWEWEE
WEEWEWEEWEWEWEWEWEWEWEWEWEWEWEWEEWEWW
EEWEWEWEWEWEWEWEWEWEWEWEWEEWEWEEWEWEE
WEWEWEWEWEWEWEWEWEWEEWEWEEWEWEWEWEWEW
WEWEWEWEWEWEWEEWEWEEWEWEWEWEWEWEWEWEE
WEWEWEWEEWEWEEWEWEWEWEWEWEWEWEWEWEWEW
WEEWEWEEWEWEWEWEWEWEWEWEWEWEWEWEEWEWE
EEWEWEWEWEWEWEWEWEWEWEWEWEEWEWEEWEWEW
WEWEWEWEWEWEWEWEWEWEEWEWEEWEWEWEWEWEE
WEWEWEWEWEWEWEEWEWEEWEWEWEWEWEWEWEWEW
WEWEWEWEEWEWEEWEWEWEWEWEWEWEWEWEWEWEE
EEWEWEWEWEWEWEWEWEWEWEWEWEEWEWEEWEWEW
WEWEWEWEWEWEWEWEWEWEEWEWEEWEWEWEWEWEE
WEWEWEWEWEWEWEEWEWEEWEWEWEWEWEWEWEWEW
WEWEWEWEEWEWEEWEWEWEWEWEWEWEWEWEWEWEE
WEEWEWEEWEWEWEWEWEWEWEWEWEWEWEWEEWEWW
EEWEWEWEWEWEWEWEWEWEWEWEWEEWEWEEWEWEE
WEWEWEWEWEWEWEWEWEWEEWEWEEWEWEWEWEWEW
WEWEWEWEWEWEWEEWEWEEWEWEWEWEWEWEWEWEE
WEWEWEWEWEEWEWEEWEWEWEWEWEWEWEWEWEWEW
WEWEWEEWEWEEWEWEWEWEWEWEWEWEWEWEWEWEE
EWEWEEWEWEWEWEWEWEWEWEWEWEWEWEEWEWEEW
WEWEWEWEWEWEWEWEWEWEWEWEEWEWEEWEWEWEW
WEWEWEWEWEWEWEWEWEEWEWEEWEWEWEWEWEWEE
WEWEWEWEWEWEEWEWEEWEWEWEWEWEWEWEWEWEW
WEWEWEEWEWEEWEWEWEWEWEWEWEWEWEWEWEWEE
EWEWEEWEWEWEWEWEWEWEWEWEWEWEWEEWEWEEW
WEWEWEWEWEWEWEWEWEWEWEWEEWEWEEWEWEWEW
WEWEWEWEWEWEWEWEWEWEWEWEEWEWEEWEWEWEW
WEWEWEWEWEWEWEWEWEWEWEWEEWEWEEWEWEWEW